Player,Pos,Age,Tm,G,MP,FG,FGA,FG%,3P,3PA,3P%,2P,2PA,2P%,eFG%,FT,FTA,FT%,PTS
Álex Abrines,SG,24,OKC,75,1134,115,291,0.395,84,221,0.38,31,70,0.443,0.54,39,46,0.848,353
Quincy Acy,PF,27,BRK,70,1359,130,365,0.356,102,292,0.349,28,73,0.384,0.496,49,60,0.817,411
Steven Adams,C,24,OKC,76,2487,448,712,0.629,0,2,0.0,448,710,0.631,0.629,160,286,0.559,1056
Bam Adebayo,C,20,MIA,69,1368,174,340,0.512,0,7,0.0,174,333,0.523,0.512,129,179,0.721,477
Arron Afflalo,SG,32,ORL,53,682,65,162,0.401,27,70,0.386,38,92,0.413,0.485,22,26,0.846,179
Cole Aldrich,C,29,MIN,21,49,5,15,0.333,0,0,,5,15,0.333,0.333,2,6,0.333,12
LaMarcus Aldridge,C,32,SAS,75,2509,687,1347,0.51,27,92,0.293,660,1255,0.526,0.52,334,399,0.837,1735
Jarrett Allen,C,19,BRK,72,1441,234,397,0.589,5,15,0.333,229,382,0.599,0.596,114,147,0.776,587
Kadeem Allen,PG,25,BOS,18,107,6,22,0.273,0,11,0.0,6,11,0.545,0.273,7,9,0.778,19
Tony Allen,SF,36,NOP,22,273,44,91,0.484,4,12,0.333,40,79,0.506,0.505,11,21,0.524,103
Al-Farouq Aminu,PF,27,POR,69,2072,230,582,0.395,125,339,0.369,105,243,0.432,0.503,59,80,0.738,644
Justin Anderson,SF,24,PHI,38,519,87,202,0.431,34,103,0.33,53,99,0.535,0.515,28,38,0.737,236
Kyle Anderson,SF,24,SAS,74,1978,231,438,0.527,19,57,0.333,212,381,0.556,0.549,104,146,0.712,585
Ryan Anderson,PF,29,HOU,66,1725,207,480,0.431,131,339,0.386,76,141,0.539,0.568,72,93,0.774,617
Ike Anigbogu,C,19,IND,11,30,4,9,0.444,0,0,,4,9,0.444,0.444,5,6,0.833,13
Giannis Antetokounmpo,PF,23,MIL,75,2756,742,1402,0.529,43,140,0.307,699,1262,0.554,0.545,487,641,0.76,2014
Carmelo Anthony,PF,33,OKC,78,2501,472,1168,0.404,169,474,0.357,303,694,0.437,0.476,148,193,0.767,1261
OG Anunoby,SF,20,TOR,74,1481,163,346,0.471,73,197,0.371,90,149,0.604,0.577,39,62,0.629,438
Ryan Arcidiacono,PG,23,CHI,24,304,17,41,0.415,9,31,0.29,8,10,0.8,0.524,5,6,0.833,48
Trevor Ariza,SF,32,HOU,67,2269,268,651,0.412,170,462,0.368,98,189,0.519,0.542,76,89,0.854,782
Darrell Arthur,PF,29,DEN,19,141,22,47,0.468,8,23,0.348,14,24,0.583,0.553,2,3,0.667,54
Jamel Artis,SG,25,ORL,15,279,31,79,0.392,8,29,0.276,23,50,0.46,0.443,7,12,0.583,77
Ömer Aşık,C,31,TOT,18,182,9,22,0.409,0,0,,9,22,0.409,0.409,4,13,0.308,22
D.J. Augustin,PG,30,ORL,75,1760,244,540,0.452,114,272,0.419,130,268,0.485,0.557,164,189,0.868,766
Luke Babbitt,SF,28,TOT,50,715,91,215,0.423,60,156,0.385,31,59,0.525,0.563,17,22,0.773,259
Dwayne Bacon,SG,22,CHO,53,713,72,192,0.375,11,43,0.256,61,149,0.409,0.404,20,25,0.8,175
Ron Baker,SG,24,NYK,29,385,20,59,0.339,11,33,0.333,9,26,0.346,0.432,20,26,0.769,71
Wade Baldwin,PG,21,POR,7,80,14,21,0.667,4,5,0.8,10,16,0.625,0.762,6,10,0.6,38
Lonzo Ball,PG,20,LAL,52,1780,203,564,0.36,90,295,0.305,113,269,0.42,0.44,32,71,0.451,528
J.J. Barea,PG,33,DAL,69,1603,303,690,0.439,115,313,0.367,188,377,0.499,0.522,80,102,0.784,801
Harrison Barnes,PF,25,DAL,77,2634,537,1208,0.445,119,333,0.357,418,875,0.478,0.494,259,313,0.827,1452
Will Barton,SG,27,DEN,81,2683,465,1028,0.452,156,422,0.37,309,606,0.51,0.528,182,226,0.805,1268
Nicolas Batum,SG,29,CHO,64,1981,270,650,0.415,92,274,0.336,178,376,0.473,0.486,108,130,0.831,740
Jerryd Bayless,SG,29,PHI,39,925,109,262,0.416,54,146,0.37,55,116,0.474,0.519,35,44,0.795,307
Aron Baynes,C,31,BOS,81,1485,210,446,0.471,3,21,0.143,207,425,0.487,0.474,59,78,0.756,482
Kent Bazemore,SG,28,ATL,65,1789,284,676,0.42,108,274,0.394,176,402,0.438,0.5,160,201,0.796,836
Bradley Beal,SG,24,WAS,82,2977,683,1484,0.46,199,530,0.375,484,954,0.507,0.527,292,369,0.791,1857
Malik Beasley,SG,21,DEN,62,583,73,178,0.41,28,82,0.341,45,96,0.469,0.489,22,33,0.667,196
Michael Beasley,PF,29,NYK,74,1653,409,807,0.507,34,86,0.395,375,721,0.52,0.528,124,159,0.78,976
Marco Belinelli,SG,31,TOT,80,1947,337,764,0.441,149,395,0.377,188,369,0.509,0.539,148,163,0.908,971
Jordan Bell,C,23,GSW,57,809,116,185,0.627,0,4,0.0,116,181,0.641,0.627,30,44,0.682,262
DeAndre' Bembry,SF,23,ATL,26,455,53,128,0.414,11,30,0.367,42,98,0.429,0.457,19,33,0.576,136
Dragan Bender,PF,20,PHO,82,2069,187,484,0.386,118,322,0.366,69,162,0.426,0.508,39,51,0.765,531
Dāvis Bertāns,PF,25,SAS,77,1086,161,366,0.44,94,252,0.373,67,114,0.588,0.568,40,49,0.816,456
Patrick Beverley,SG,29,LAC,11,334,48,119,0.403,24,60,0.4,24,59,0.407,0.504,14,17,0.824,134
Khem Birch,C,25,ORL,42,578,68,126,0.54,0,0,,68,126,0.54,0.54,42,61,0.689,178
Jabari Bird,SG,23,BOS,13,115,15,26,0.577,3,7,0.429,12,19,0.632,0.635,6,13,0.462,39
Bismack Biyombo,C,25,ORL,82,1495,183,352,0.52,0,1,0.0,183,351,0.521,0.52,102,157,0.65,468
Nemanja Bjelica,PF,29,MIN,67,1371,171,371,0.461,76,183,0.415,95,188,0.505,0.563,36,45,0.8,454
Tarik Black,C,26,HOU,51,536,75,127,0.591,1,11,0.091,74,116,0.638,0.594,29,63,0.46,180
Antonio Blakeney,SG,21,CHI,19,314,53,143,0.371,15,52,0.288,38,91,0.418,0.423,30,39,0.769,151
Eric Bledsoe,PG,28,TOT,74,2322,468,989,0.473,125,360,0.347,343,629,0.545,0.536,252,317,0.795,1313
Vander Blue,SG,25,LAL,5,45,1,5,0.2,0,2,0.0,1,3,0.333,0.2,1,2,0.5,3
Bogdan Bogdanović,SG,25,SAC,78,2175,344,772,0.446,129,329,0.392,215,443,0.485,0.529,100,119,0.84,917
Bojan Bogdanović,SF,28,IND,80,2464,404,852,0.474,155,386,0.402,249,466,0.534,0.565,178,205,0.868,1141
Andrew Bogut,C,33,LAL,24,216,17,25,0.68,0,0,,17,25,0.68,0.68,2,2,1.0,36
Joel Bolomboy,PF,24,MIL,6,38,3,6,0.5,0,1,0.0,3,5,0.6,0.5,3,6,0.5,9
Devin Booker,SG,21,PHO,54,1865,455,1054,0.432,147,384,0.383,308,670,0.46,0.501,289,329,0.878,1346
Trevor Booker,PF,30,TOT,68,1158,177,343,0.516,8,33,0.242,169,310,0.545,0.528,66,93,0.71,428
Chris Boucher,PF,25,GSW,1,1,0,1,0.0,0,1,0.0,0,0,,0.0,0,0,,0
Avery Bradley,SG,27,TOT,46,1433,259,625,0.414,75,203,0.369,184,422,0.436,0.474,63,82,0.768,656
Tony Bradley,C,20,UTA,9,29,3,11,0.273,0,1,0.0,3,10,0.3,0.273,2,2,1.0,8
Corey Brewer,SF-SG,31,TOT,72,1208,142,316,0.449,31,110,0.282,111,206,0.539,0.498,65,90,0.722,380
Malcolm Brogdon,PG,25,MIL,48,1436,244,503,0.485,62,161,0.385,182,342,0.532,0.547,75,85,0.882,625
Aaron Brooks,PG,33,MIN,32,189,28,69,0.406,11,31,0.355,17,38,0.447,0.486,8,11,0.727,75
Dillon Brooks,SF,22,MEM,82,2350,340,772,0.44,94,264,0.356,246,508,0.484,0.501,124,166,0.747,898
MarShon Brooks,SG,29,MEM,7,193,51,102,0.5,19,32,0.594,32,70,0.457,0.593,20,23,0.87,141
Anthony Brown,SF,25,MIN,1,4,1,1,1.0,1,1,1.0,0,0,,1.5,0,0,,3
Bobby Brown,PG,33,HOU,20,115,19,58,0.328,11,40,0.275,8,18,0.444,0.422,1,2,0.5,50
Jaylen Brown,SG,21,BOS,70,2152,373,803,0.465,121,306,0.395,252,497,0.507,0.54,150,233,0.644,1017
Lorenzo Brown,PG,27,TOR,14,139,14,34,0.412,2,12,0.167,12,22,0.545,0.441,2,2,1.0,32
Markel Brown,SG,26,HOU,4,31,2,7,0.286,1,5,0.2,1,2,0.5,0.357,0,0,,5
Sterling Brown,SG,22,MIL,54,776,82,205,0.4,32,91,0.352,50,114,0.439,0.478,21,24,0.875,217
Nicolás Brussino,SF,24,ATL,4,10,0,2,0.0,0,2,0.0,0,0,,0.0,0,0,,0
Thomas Bryant,C,20,LAL,15,72,8,21,0.381,1,10,0.1,7,11,0.636,0.405,5,9,0.556,22
Reggie Bullock,SF,26,DET,62,1732,267,546,0.489,125,281,0.445,142,265,0.536,0.603,39,49,0.796,698
Trey Burke,PG,25,NYK,36,785,193,384,0.503,38,105,0.362,155,279,0.556,0.552,37,57,0.649,461
Alec Burks,SG,26,UTA,64,1059,170,414,0.411,47,142,0.331,123,272,0.452,0.467,107,124,0.863,494
Jimmy Butler,SG,28,MIN,59,2164,437,921,0.474,70,200,0.35,367,721,0.509,0.512,363,425,0.854,1307
Dwight Buycks,PG,28,DET,29,427,82,198,0.414,15,45,0.333,67,153,0.438,0.452,36,41,0.878,215
Bruno Caboclo,SF,22,TOT,12,107,9,31,0.29,3,17,0.176,6,14,0.429,0.339,5,6,0.833,26
José Calderón,PG,36,CLE,57,914,93,185,0.503,45,97,0.464,48,88,0.545,0.624,24,30,0.8,255
Kentavious Caldwell-Pope,SG,24,LAL,74,2458,340,798,0.426,159,415,0.383,181,383,0.473,0.526,153,194,0.789,992
Isaiah Canaan,PG-SG,26,TOT,20,422,52,137,0.38,22,66,0.333,30,71,0.423,0.46,46,51,0.902,172
Clint Capela,C,23,HOU,74,2034,441,676,0.652,0,1,0.0,441,675,0.653,0.652,144,257,0.56,1026
DeMarre Carroll,PF,31,BRK,73,2180,325,785,0.414,145,391,0.371,180,394,0.457,0.506,188,246,0.764,983
Vince Carter,SF,41,SAC,58,1026,114,283,0.403,57,165,0.345,57,118,0.483,0.504,28,37,0.757,313
Michael Carter-Williams,PG,26,CHO,52,835,76,229,0.332,14,59,0.237,62,170,0.365,0.362,73,89,0.82,239
Alex Caruso,PG,23,LAL,37,562,50,116,0.431,13,43,0.302,37,73,0.507,0.487,21,30,0.7,134
Omri Casspi,SF,29,GSW,53,740,120,207,0.58,10,22,0.455,110,185,0.595,0.604,50,69,0.725,300
Willie Cauley-Stein,C,24,SAC,73,2044,388,773,0.502,3,12,0.25,385,761,0.506,0.504,153,247,0.619,932
Tyler Cavanaugh,PF,23,ATL,39,518,67,152,0.441,32,89,0.36,35,63,0.556,0.546,17,21,0.81,183
Mario Chalmers,PG,31,MEM,66,1421,168,443,0.379,53,191,0.277,115,252,0.456,0.439,118,138,0.855,507
Tyson Chandler,C,35,PHO,46,1151,121,187,0.647,0,0,,121,187,0.647,0.647,58,93,0.624,300
Wilson Chandler,SF,30,DEN,74,2346,281,631,0.445,88,246,0.358,193,385,0.501,0.515,88,114,0.772,738
Marquese Chriss,PF,20,PHO,72,1527,202,477,0.423,56,190,0.295,146,287,0.509,0.482,96,158,0.608,556
Ian Clark,SG,26,NOP,74,1455,222,495,0.448,62,195,0.318,160,300,0.533,0.511,45,59,0.763,551
Jordan Clarkson,SG,25,TOT,81,1888,430,954,0.451,112,318,0.352,318,636,0.5,0.509,152,190,0.8,1124
Gian Clavell,SG,24,DAL,7,64,6,18,0.333,6,15,0.4,0,3,0.0,0.5,2,2,1.0,20
Antonius Cleveland,SG,23,TOT,17,123,8,21,0.381,3,4,0.75,5,17,0.294,0.452,4,6,0.667,23
John Collins,PF,20,ATL,74,1785,314,545,0.576,16,47,0.34,298,498,0.598,0.591,133,186,0.715,777
Zach Collins,C,20,POR,66,1045,115,289,0.398,35,113,0.31,80,176,0.455,0.458,27,42,0.643,292
Kyle Collinsworth,SF,26,DAL,32,480,38,99,0.384,4,17,0.235,34,82,0.415,0.404,21,40,0.525,101
Darren Collison,PG,30,IND,69,2018,316,638,0.495,96,205,0.468,220,433,0.508,0.571,127,144,0.882,855
Nick Collison,PF,37,OKC,15,75,13,19,0.684,0,0,,13,19,0.684,0.684,5,13,0.385,31
Mike Conley,PG,30,MEM,12,373,64,168,0.381,24,77,0.312,40,91,0.44,0.452,53,66,0.803,205
Pat Connaughton,SG,25,POR,82,1488,165,390,0.423,74,210,0.352,91,180,0.506,0.518,37,44,0.841,441
Quinn Cook,PG,24,GSW,33,740,122,252,0.484,46,104,0.442,76,148,0.514,0.575,22,25,0.88,312
Charles Cooke,SG,23,NOP,13,38,2,14,0.143,1,8,0.125,1,6,0.167,0.179,1,2,0.5,6
Jack Cooley,PF,26,SAC,7,87,13,27,0.481,0,0,,13,27,0.481,0.481,14,19,0.737,40
Matt Costello,C,24,SAS,4,32,2,4,0.5,0,0,,2,4,0.5,0.5,0,0,,4
DeMarcus Cousins,C,27,NOP,48,1737,406,864,0.47,104,294,0.354,302,570,0.53,0.53,294,394,0.746,1210
Robert Covington,SF,27,PHI,80,2532,345,836,0.413,203,550,0.369,142,286,0.497,0.534,116,136,0.853,1009
Allen Crabbe,SG,25,BRK,75,2197,337,827,0.407,201,532,0.378,136,295,0.461,0.529,115,135,0.852,990
Torrey Craig,SF,27,DEN,39,629,62,137,0.453,17,58,0.293,45,79,0.57,0.515,22,35,0.629,163
Jamal Crawford,SG,37,MIN,80,1653,308,742,0.415,104,314,0.331,204,428,0.477,0.485,102,113,0.903,822
Jordan Crawford,SG,29,NOP,5,53,12,27,0.444,8,14,0.571,4,13,0.308,0.593,1,1,1.0,33
Jae Crowder,SF,27,TOT,80,2090,271,671,0.404,110,341,0.323,161,330,0.488,0.486,121,148,0.818,773
Dante Cunningham,SF,30,TOT,73,1562,164,364,0.451,58,168,0.345,106,196,0.541,0.53,31,52,0.596,417
Stephen Curry,PG,29,GSW,51,1631,428,864,0.495,212,501,0.423,216,363,0.595,0.618,278,302,0.921,1346
Troy Daniels,SG,26,PHO,79,1622,232,575,0.403,183,458,0.4,49,117,0.419,0.563,56,64,0.875,703
Anthony Davis,PF,24,NOP,75,2727,780,1462,0.534,55,162,0.34,725,1300,0.558,0.552,495,598,0.828,2110
Deyonta Davis,C,21,MEM,62,943,161,265,0.608,0,0,,161,265,0.608,0.608,38,57,0.667,360
Ed Davis,C,28,POR,78,1471,170,292,0.582,0,1,0.0,170,291,0.584,0.582,74,111,0.667,414
Dewayne Dedmon,C,28,ATL,62,1542,250,477,0.524,50,141,0.355,200,336,0.595,0.577,67,86,0.779,617
Sam Dekker,PF,23,LAC,73,883,128,259,0.494,10,60,0.167,118,199,0.593,0.514,37,56,0.661,303
Malcolm Delaney,PG,28,ATL,54,1014,109,285,0.382,46,124,0.371,63,161,0.391,0.463,74,92,0.804,338
Matthew Dellavedova,PG,27,MIL,38,712,55,152,0.362,29,78,0.372,26,74,0.351,0.457,25,27,0.926,164
Luol Deng,SF,32,LAL,1,13,1,2,0.5,0,0,,1,2,0.5,0.5,0,0,,2
DeMar DeRozan,SG,28,TOR,80,2711,645,1413,0.456,89,287,0.31,556,1126,0.494,0.488,461,559,0.825,1840
Cheick Diallo,PF,21,NOP,52,581,102,176,0.58,0,0,,102,176,0.58,0.58,50,66,0.758,254
Gorgui Dieng,C,28,MIN,79,1333,186,388,0.479,19,61,0.311,167,327,0.511,0.504,79,102,0.775,470
Spencer Dinwiddie,PG,24,BRK,80,2306,324,838,0.387,141,433,0.326,183,405,0.452,0.471,218,268,0.813,1007
Tyler Dorsey,SG,21,ATL,56,974,144,382,0.377,72,199,0.362,72,183,0.393,0.471,45,63,0.714,405
Damyean Dotson,SG,23,NYK,44,474,72,161,0.447,22,68,0.324,50,93,0.538,0.516,16,23,0.696,182
Milton Doyle,SG,24,BRK,10,125,13,47,0.277,4,23,0.174,9,24,0.375,0.319,4,8,0.5,34
PJ Dozier,PG,21,OKC,2,3,1,2,0.5,0,0,,1,2,0.5,0.5,0,0,,2
Goran Dragić,PG,31,MIA,75,2378,484,1075,0.45,111,300,0.37,373,775,0.481,0.502,217,271,0.801,1296
Larry Drew II,PG,27,TOT,10,70,7,24,0.292,3,9,0.333,4,15,0.267,0.354,0,0,,17
Andre Drummond,C,24,DET,78,2625,466,881,0.529,0,11,0.0,466,870,0.536,0.529,239,395,0.605,1171
Jared Dudley,PF,32,PHO,48,686,48,122,0.393,29,80,0.363,19,42,0.452,0.512,27,35,0.771,152
Kris Dunn,PG,23,CHI,52,1525,286,666,0.429,43,134,0.321,243,532,0.457,0.462,84,114,0.737,699
Kevin Durant,SF,29,GSW,68,2325,630,1222,0.516,173,413,0.419,457,809,0.565,0.586,359,404,0.889,1792
Jarell Eddie,SF,26,TOT,3,9,0,2,0.0,0,2,0.0,0,0,,0.0,0,0,,0
Henry Ellenson,PF,21,DET,38,329,53,146,0.363,20,60,0.333,33,86,0.384,0.432,25,29,0.862,151
Wayne Ellington,SG,30,MIA,77,2041,285,700,0.407,227,579,0.392,58,121,0.479,0.569,67,78,0.859,864
Joel Embiid,C,23,PHI,63,1912,510,1056,0.483,66,214,0.308,444,842,0.527,0.514,359,467,0.769,1445
James Ennis III,SF,27,TOT,72,1604,182,384,0.474,51,153,0.333,131,231,0.567,0.54,97,116,0.836,512
Tyler Ennis,PG,23,LAL,54,683,94,224,0.42,14,56,0.25,80,168,0.476,0.451,22,29,0.759,224
Jawun Evans,PG,21,LAC,48,778,89,253,0.352,15,54,0.278,74,199,0.372,0.381,38,49,0.776,231
Jeremy Evans,SF,30,ATL,1,5,1,1,1.0,0,0,,1,1,1.0,1.0,0,0,,2
Tyreke Evans,PG,28,MEM,52,1607,366,809,0.452,114,286,0.399,252,523,0.482,0.523,164,209,0.785,1010
Dante Exum,PG,22,UTA,14,235,42,87,0.483,5,18,0.278,37,69,0.536,0.511,25,31,0.806,114
Kenneth Faried,PF,28,DEN,32,461,76,148,0.514,0,1,0.0,76,147,0.517,0.514,36,51,0.706,188
Derrick Favors,C,26,UTA,77,2153,395,702,0.563,14,63,0.222,381,639,0.596,0.573,140,215,0.651,944
Kay Felder,PG,22,TOT,16,140,21,70,0.3,4,19,0.211,17,51,0.333,0.329,11,12,0.917,57
Cristiano Felício,C,25,CHI,55,977,127,215,0.591,0,2,0.0,127,213,0.596,0.591,54,81,0.667,308
Raymond Felton,PG,33,OKC,82,1365,224,552,0.406,81,230,0.352,143,322,0.444,0.479,36,44,0.818,565
Terrance Ferguson,SG,19,OKC,61,763,70,169,0.414,40,120,0.333,30,49,0.612,0.533,9,10,0.9,189
Yogi Ferrell,SG,24,DAL,82,2282,311,730,0.426,134,359,0.373,177,371,0.477,0.518,82,103,0.796,838
Dorian Finney-Smith,PF,24,DAL,21,448,46,121,0.38,20,67,0.299,26,54,0.481,0.463,11,15,0.733,123
Bryn Forbes,SG,24,SAS,80,1517,209,497,0.421,89,228,0.39,120,269,0.446,0.51,48,72,0.667,555
Evan Fournier,SF,25,ORL,57,1837,368,802,0.459,127,335,0.379,241,467,0.516,0.538,150,173,0.867,1013
De'Aaron Fox,PG,20,SAC,73,2026,328,797,0.412,47,153,0.307,281,644,0.436,0.441,141,195,0.723,844
Tim Frazier,PG,27,WAS,59,838,68,172,0.395,17,56,0.304,51,116,0.44,0.445,23,30,0.767,176
Enes Freedom,C,25,NYK,71,1830,422,713,0.592,0,2,0.0,422,711,0.594,0.592,156,184,0.848,1000
Channing Frye,C,34,TOT,53,695,104,212,0.491,39,115,0.339,65,97,0.67,0.583,17,19,0.895,264
Markelle Fultz,SG,19,PHI,14,253,45,111,0.405,0,1,0.0,45,110,0.409,0.405,10,21,0.476,100
Danilo Gallinari,SF,29,LAC,21,671,102,256,0.398,36,111,0.324,66,145,0.455,0.469,81,87,0.931,321
Langston Galloway,SG,26,DET,58,863,126,340,0.371,75,218,0.344,51,122,0.418,0.481,33,41,0.805,360
Marc Gasol,C,33,MEM,73,2408,434,1033,0.42,109,320,0.341,325,713,0.456,0.473,281,337,0.834,1258
Pau Gasol,C,37,SAS,77,1812,287,627,0.458,43,120,0.358,244,507,0.481,0.492,158,209,0.756,775
Rudy Gay,PF,31,SAS,57,1231,253,537,0.471,37,118,0.314,216,419,0.516,0.506,112,145,0.772,655
Paul George,SF,27,OKC,79,2891,576,1340,0.43,244,609,0.401,332,731,0.454,0.521,338,411,0.822,1734
Marcus Georges-Hunt,SG,23,MIN,42,224,21,48,0.438,4,15,0.267,17,33,0.515,0.479,13,21,0.619,59
Jonathan Gibson,PG,30,BOS,4,40,14,23,0.609,6,12,0.5,8,11,0.727,0.739,0,0,,34
Taj Gibson,PF,32,MIN,82,2726,425,737,0.577,7,35,0.2,418,702,0.595,0.581,142,185,0.768,999
Manu Ginóbili*,SG,40,SAS,65,1299,201,463,0.434,64,192,0.333,137,271,0.506,0.503,110,131,0.84,576
Rudy Gobert,C,25,UTA,56,1816,276,444,0.622,0,0,,276,444,0.622,0.622,204,299,0.682,756
Aaron Gordon,PF,22,ORL,58,1909,375,865,0.434,115,342,0.336,260,523,0.497,0.5,157,225,0.698,1022
Eric Gordon,SG,29,HOU,69,2154,415,970,0.428,218,608,0.359,197,362,0.544,0.54,195,241,0.809,1243
Marcin Gortat,C,33,WAS,82,2075,290,560,0.518,0,0,,290,560,0.518,0.518,110,163,0.675,690
Treveon Graham,SG,24,CHO,63,1050,96,221,0.434,40,97,0.412,56,124,0.452,0.525,41,59,0.695,273
Jerami Grant,PF,23,OKC,81,1647,244,456,0.535,32,110,0.291,212,346,0.613,0.57,162,240,0.675,682
Jerian Grant,PG,25,CHI,74,1686,209,503,0.416,61,187,0.326,148,316,0.468,0.476,140,188,0.745,619
Josh Gray,PG,24,PHO,5,86,11,41,0.268,3,13,0.231,8,28,0.286,0.305,7,11,0.636,32
Danny Green,SG,30,SAS,70,1791,217,561,0.387,116,320,0.363,101,241,0.419,0.49,50,65,0.769,600
Draymond Green,PF,27,GSW,70,2287,281,619,0.454,77,256,0.301,204,363,0.562,0.516,134,173,0.775,773
Gerald Green,SG,32,HOU,41,929,168,413,0.407,110,298,0.369,58,115,0.504,0.54,51,60,0.85,497
JaMychal Green,PF,27,MEM,55,1542,223,488,0.457,43,127,0.339,180,361,0.499,0.501,80,111,0.721,569
Jeff Green,PF,31,CLE,78,1828,295,618,0.477,53,170,0.312,242,448,0.54,0.52,203,234,0.868,846
Blake Griffin,PF,28,TOT,58,1970,436,996,0.438,111,322,0.345,325,674,0.482,0.493,259,330,0.785,1242
Daniel Hamilton,SG,22,OKC,6,28,5,11,0.455,2,5,0.4,3,6,0.5,0.545,0,0,,12
Tim Hardaway Jr.,SG,25,NYK,57,1885,360,856,0.421,130,410,0.317,230,446,0.516,0.496,146,179,0.816,996
James Harden,SG,28,HOU,72,2551,651,1449,0.449,265,722,0.367,386,727,0.531,0.541,624,727,0.858,2191
Maurice Harkless,SF,24,POR,59,1264,147,297,0.495,49,118,0.415,98,179,0.547,0.577,42,59,0.712,385
Montrezl Harrell,C,24,LAC,76,1293,348,548,0.635,1,7,0.143,347,541,0.641,0.636,139,222,0.626,836
Devin Harris,PG,34,TOT,71,1340,187,454,0.412,79,227,0.348,108,227,0.476,0.499,142,170,0.835,595
Gary Harris,SG,23,DEN,67,2304,440,908,0.485,156,394,0.396,284,514,0.553,0.57,134,162,0.827,1170
Joe Harris,SG,26,BRK,78,1975,305,621,0.491,150,358,0.419,155,263,0.589,0.612,86,104,0.827,846
Tobias Harris,PF,25,TOT,80,2668,562,1221,0.46,183,445,0.411,379,776,0.488,0.535,179,216,0.829,1486
Aaron Harrison,SG,23,DAL,9,233,19,69,0.275,9,43,0.209,10,26,0.385,0.341,13,17,0.765,60
Andrew Harrison,PG,23,MEM,56,1326,181,429,0.422,47,142,0.331,134,287,0.467,0.477,124,159,0.78,533
Shaquille Harrison,PG,24,PHO,23,384,59,124,0.476,6,26,0.231,53,98,0.541,0.5,28,38,0.737,152
Josh Hart,SG,22,LAL,63,1461,176,375,0.469,78,197,0.396,98,178,0.551,0.573,66,94,0.702,496
Udonis Haslem,C,37,MIA,14,72,3,15,0.2,1,8,0.125,2,7,0.286,0.233,1,2,0.5,8
Nigel Hayes,SF,23,TOT,9,122,11,33,0.333,4,16,0.25,7,17,0.412,0.394,1,3,0.333,27
Gordon Hayward,SF,27,BOS,1,5,1,2,0.5,0,1,0.0,1,1,1.0,0.5,0,0,,2
Reggie Hearn,SG,26,DET,3,7,1,2,0.5,1,2,0.5,0,0,,0.75,0,0,,3
Myke Henry,SF,25,MEM,20,378,41,109,0.376,19,58,0.328,22,51,0.431,0.463,6,10,0.6,107
John Henson,C,27,MIL,76,1970,287,502,0.572,1,7,0.143,286,495,0.578,0.573,90,158,0.57,665
Juancho Hernangómez,PF,22,DEN,25,277,29,75,0.387,14,50,0.28,15,25,0.6,0.48,10,12,0.833,82
Willy Hernangómez,C,23,TOT,48,495,91,164,0.555,5,12,0.417,86,152,0.566,0.57,59,90,0.656,246
Mario Hezonja,SF,22,ORL,75,1657,273,617,0.442,90,267,0.337,183,350,0.523,0.515,86,105,0.819,722
Isaiah Hicks,PF,23,NYK,18,240,33,72,0.458,2,9,0.222,31,63,0.492,0.472,12,18,0.667,80
Buddy Hield,SG,25,SAC,80,2024,416,933,0.446,176,408,0.431,240,525,0.457,0.54,71,81,0.877,1079
Nenê,C,35,HOU,52,758,136,239,0.569,0,2,0.0,136,237,0.574,0.569,68,107,0.636,340
George Hill,PG,31,TOT,67,1812,236,513,0.46,85,205,0.415,151,308,0.49,0.543,110,140,0.786,667
Solomon Hill,SF,26,NOP,12,187,11,41,0.268,4,21,0.19,7,20,0.35,0.317,3,6,0.5,29
Darrun Hilliard,SG,24,SAS,14,95,5,19,0.263,0,6,0.0,5,13,0.385,0.263,6,7,0.857,16
Jrue Holiday,SG,27,NOP,81,2927,615,1244,0.494,120,356,0.337,495,888,0.557,0.543,187,238,0.786,1537
Justin Holiday,SG,28,CHI,72,2265,290,782,0.371,161,449,0.359,129,333,0.387,0.474,135,164,0.823,876
John Holland,SF,29,CLE,24,174,17,59,0.288,11,36,0.306,6,23,0.261,0.381,9,13,0.692,54
Rondae Hollis-Jefferson,SF,23,BRK,68,1920,342,724,0.472,13,54,0.241,329,670,0.491,0.481,249,316,0.788,946
Richaun Holmes,C,24,PHI,48,746,135,241,0.56,4,31,0.129,131,210,0.624,0.568,37,56,0.661,311
Rodney Hood,SG,25,TOT,60,1616,322,751,0.429,127,333,0.381,195,418,0.467,0.513,111,129,0.86,882
Scotty Hopson,SG,28,DAL,1,8,0,1,0.0,0,0,,0,1,0.0,0.0,1,2,0.5,1
Al Horford,C,31,BOS,72,2277,368,753,0.489,97,226,0.429,271,527,0.514,0.553,94,120,0.783,927
Danuel House Jr.,SG,24,PHO,23,403,56,129,0.434,15,58,0.259,41,71,0.577,0.492,25,31,0.806,152
Dwight Howard,C,32,CHO,81,2463,506,911,0.555,1,7,0.143,505,904,0.559,0.556,334,582,0.574,1347
Josh Huestis,PF,26,OKC,69,982,60,182,0.33,33,115,0.287,27,67,0.403,0.42,6,20,0.3,159
R.J. Hunter,SG,24,HOU,5,45,7,20,0.35,3,14,0.214,4,6,0.667,0.425,2,2,1.0,19
Vince Hunter,PF,23,MEM,4,7,3,5,0.6,0,0,,3,5,0.6,0.6,0,0,,6
Serge Ibaka,PF,28,TOR,76,2093,379,784,0.483,107,297,0.36,272,487,0.559,0.552,94,118,0.797,959
Andre Iguodala,SF,34,GSW,64,1622,148,320,0.463,33,117,0.282,115,203,0.567,0.514,55,87,0.632,384
Ersan İlyasova,PF,30,TOT,69,1729,277,613,0.452,91,253,0.36,186,360,0.517,0.526,105,135,0.778,750
Joe Ingles,SF,30,UTA,82,2578,335,718,0.467,204,464,0.44,131,254,0.516,0.609,66,83,0.795,940
Andre Ingram,SG,32,LAL,2,64,8,17,0.471,5,9,0.556,3,8,0.375,0.618,3,3,1.0,24
Brandon Ingram,SF,20,LAL,59,1975,358,761,0.47,41,105,0.39,317,656,0.483,0.497,192,282,0.681,949
Kyrie Irving,PG,25,BOS,60,1931,534,1087,0.491,166,407,0.408,368,680,0.541,0.568,232,261,0.889,1466
Jonathan Isaac,PF,20,ORL,27,536,55,145,0.379,16,46,0.348,39,99,0.394,0.434,19,25,0.76,145
Wes Iwundu,SF,23,ORL,62,1020,93,218,0.427,9,46,0.196,84,172,0.488,0.447,34,47,0.723,229
Jarrett Jack,PG,34,NYK,62,1548,189,443,0.427,25,86,0.291,164,357,0.459,0.455,63,75,0.84,466
Aaron Jackson,PG,31,HOU,1,35,3,9,0.333,1,4,0.25,2,5,0.4,0.389,1,2,0.5,8
Demetrius Jackson,PG,23,TOT,15,80,7,18,0.389,1,7,0.143,6,11,0.545,0.417,1,2,0.5,16
Josh Jackson,SF,20,PHO,77,1959,389,932,0.417,57,217,0.263,332,715,0.464,0.448,177,279,0.634,1012
Justin Jackson,SF,22,SAC,68,1506,185,419,0.442,57,185,0.308,128,234,0.547,0.51,26,36,0.722,453
Reggie Jackson,PG,27,DET,45,1201,246,577,0.426,52,169,0.308,194,408,0.475,0.471,112,134,0.836,656
LeBron James,PF,33,CLE,82,3026,857,1580,0.542,149,406,0.367,708,1174,0.603,0.59,388,531,0.731,2251
Mike James,PG,27,TOT,36,687,123,321,0.383,26,98,0.265,97,223,0.435,0.424,64,84,0.762,336
Al Jefferson,C,33,IND,36,484,111,208,0.534,0,3,0.0,111,205,0.541,0.534,30,36,0.833,252
Richard Jefferson,SF,37,DEN,20,163,12,27,0.444,2,7,0.286,10,20,0.5,0.481,4,7,0.571,30
Brandon Jennings,PG,28,MIL,14,205,27,72,0.375,9,33,0.273,18,39,0.462,0.438,10,10,1.0,73
Jonas Jerebko,PF,30,UTA,74,1134,159,341,0.466,65,157,0.414,94,184,0.511,0.562,46,57,0.807,429
Amir Johnson,C,30,PHI,74,1171,140,260,0.538,10,32,0.313,130,228,0.57,0.558,52,85,0.612,342
Brice Johnson,PF,23,TOT,18,98,20,42,0.476,0,1,0.0,20,41,0.488,0.476,3,5,0.6,43
Dakari Johnson,C,22,OKC,31,161,22,39,0.564,0,0,,22,39,0.564,0.564,11,20,0.55,55
James Johnson,PF,30,MIA,73,1943,309,614,0.503,57,185,0.308,252,429,0.587,0.55,113,162,0.698,788
Joe Johnson,SF,36,TOT,55,1205,146,360,0.406,40,145,0.276,106,215,0.493,0.461,40,45,0.889,372
Omari Johnson,PF,28,MEM,4,75,9,21,0.429,4,12,0.333,5,9,0.556,0.524,0,0,,22
Stanley Johnson,SF,21,DET,69,1894,210,560,0.375,67,234,0.286,143,326,0.439,0.435,112,145,0.772,599
Tyler Johnson,PG,25,MIA,72,2052,309,711,0.435,119,324,0.367,190,387,0.491,0.518,106,129,0.822,843
Wesley Johnson,SF,30,LAC,74,1486,150,368,0.408,60,177,0.339,90,191,0.471,0.489,43,58,0.741,403
Nikola Jokić,C,22,DEN,75,2443,504,1010,0.499,111,280,0.396,393,730,0.538,0.554,266,313,0.85,1385
Damian Jones,C,22,GSW,15,89,11,22,0.5,0,0,,11,22,0.5,0.5,3,5,0.6,25
Derrick Jones Jr.,SF,20,TOT,20,245,21,53,0.396,3,18,0.167,18,35,0.514,0.425,16,24,0.667,61
Jalen Jones,SF,24,TOT,16,181,26,68,0.382,10,26,0.385,16,42,0.381,0.456,12,19,0.632,74
Tyus Jones,PG,21,MIN,82,1467,150,328,0.457,45,129,0.349,105,199,0.528,0.526,71,81,0.877,416
DeAndre Jordan,C,29,LAC,77,2424,373,578,0.645,0,0,,373,578,0.645,0.645,181,312,0.58,927
Cory Joseph,PG,26,IND,82,2210,256,604,0.424,67,190,0.353,189,414,0.457,0.479,70,94,0.745,649
Frank Kaminsky,PF,24,CHO,79,1835,307,716,0.429,104,274,0.38,203,442,0.459,0.501,155,194,0.799,873
Luke Kennard,SG,21,DET,73,1463,206,465,0.443,81,195,0.415,125,270,0.463,0.53,65,76,0.855,558
Michael Kidd-Gilchrist,SF,24,CHO,74,1850,282,560,0.504,0,2,0.0,282,558,0.505,0.504,117,171,0.684,681
Sean Kilpatrick,SG,28,TOT,52,640,110,294,0.374,46,144,0.319,64,150,0.427,0.452,64,72,0.889,330
Maxi Kleber,PF,26,DAL,72,1206,151,309,0.489,40,128,0.313,111,181,0.613,0.553,44,59,0.746,386
Furkan Korkmaz,SG,20,PHI,14,80,8,28,0.286,5,17,0.294,3,11,0.273,0.375,2,4,0.5,23
Luke Kornet,PF,22,NYK,20,326,49,125,0.392,28,79,0.354,21,46,0.457,0.504,8,11,0.727,134
Kyle Korver,SG,36,CLE,73,1574,222,484,0.459,164,376,0.436,58,108,0.537,0.628,64,72,0.889,672
Kosta Koufos,C,28,SAC,71,1391,222,389,0.571,0,0,,222,389,0.571,0.571,33,74,0.446,477
Kyle Kuzma,PF,22,LAL,77,2401,468,1039,0.45,159,434,0.366,309,605,0.511,0.527,147,208,0.707,1242
Mindaugas Kuzminskas,SF,28,NYK,1,2,0,2,0.0,0,0,,0,2,0.0,0.0,0,0,,0
Skal Labissière,PF,21,SAC,60,1240,205,458,0.448,18,51,0.353,187,407,0.459,0.467,95,118,0.805,523
Jeremy Lamb,SG,25,CHO,80,1967,380,832,0.457,94,254,0.37,286,578,0.495,0.513,179,208,0.861,1033
Shane Larkin,PG,25,BOS,54,775,84,219,0.384,31,86,0.36,53,133,0.398,0.454,32,37,0.865,231
Joffrey Lauvergne,C,26,SAS,55,534,98,190,0.516,0,5,0.0,98,185,0.53,0.516,30,47,0.638,226
Zach LaVine,SG,22,CHI,24,656,136,355,0.383,42,123,0.341,94,232,0.405,0.442,87,107,0.813,401
Jake Layman,SF,23,POR,35,160,14,47,0.298,4,20,0.2,10,27,0.37,0.34,2,3,0.667,34
T.J. Leaf,PF,20,IND,53,459,64,136,0.471,18,42,0.429,46,94,0.489,0.537,10,16,0.625,156
Courtney Lee,SG,32,NYK,76,2310,343,755,0.454,113,278,0.406,230,477,0.482,0.529,114,124,0.919,913
Damion Lee,SG,25,ATL,15,404,62,152,0.408,15,60,0.25,47,92,0.511,0.457,22,29,0.759,161
Walt Lemon Jr.,PG,25,NOP,5,35,7,16,0.438,1,1,1.0,6,15,0.4,0.469,2,3,0.667,17
Alex Len,C,24,PHO,69,1395,214,378,0.566,1,3,0.333,213,375,0.568,0.567,158,231,0.684,587
Kawhi Leonard,SF,26,SAS,9,210,52,111,0.468,11,35,0.314,41,76,0.539,0.518,31,38,0.816,146
Meyers Leonard,C,25,POR,33,254,46,78,0.59,11,26,0.423,35,52,0.673,0.66,9,11,0.818,112
Jon Leuer,PF,28,DET,8,136,15,36,0.417,0,3,0.0,15,33,0.455,0.417,13,15,0.867,43
Caris LeVert,SF,23,BRK,71,1864,320,735,0.435,85,245,0.347,235,490,0.48,0.493,133,187,0.711,858
DeAndre Liggins,SG,29,TOT,58,724,40,106,0.377,19,53,0.358,21,53,0.396,0.467,2,5,0.4,101
Damian Lillard,PG,27,POR,73,2670,621,1415,0.439,227,629,0.361,394,786,0.501,0.519,493,538,0.916,1962
Jeremy Lin,PG,29,BRK,1,25,5,12,0.417,1,2,0.5,4,10,0.4,0.458,7,7,1.0,18
Shaun Livingston,PG,32,GSW,71,1129,172,343,0.501,0,5,0.0,172,338,0.509,0.501,50,61,0.82,394
Kevon Looney,C,21,GSW,66,910,112,193,0.58,1,5,0.2,111,188,0.59,0.583,42,77,0.545,267
Brook Lopez,C,29,LAL,74,1735,369,793,0.465,112,325,0.345,257,468,0.549,0.536,111,158,0.703,961
Robin Lopez,C,29,CHI,64,1690,342,645,0.53,4,14,0.286,338,631,0.536,0.533,68,90,0.756,756
Kevin Love,C,29,CLE,59,1651,334,729,0.458,137,330,0.415,197,399,0.494,0.552,234,266,0.88,1039
Kyle Lowry,PG,31,TOR,78,2510,403,944,0.427,238,596,0.399,165,348,0.474,0.553,223,261,0.854,1267
Timothé Luwawu-Cabarrot,SF,22,PHI,52,807,100,267,0.375,53,158,0.335,47,109,0.431,0.474,46,58,0.793,299
Tyler Lydon,PF,21,DEN,1,2,0,0,,0,0,,0,0,,,0,0,,0
Trey Lyles,PF,22,DEN,73,1391,270,550,0.491,83,218,0.381,187,332,0.563,0.566,101,143,0.706,724
Shelvin Mack,PG,27,ORL,69,1365,178,414,0.43,48,139,0.345,130,275,0.473,0.488,69,97,0.711,473
Josh Magette,PG,28,ATL,18,216,15,46,0.326,8,22,0.364,7,24,0.292,0.413,8,8,1.0,46
Ian Mahinmi,C,31,WAS,77,1145,138,248,0.556,0,2,0.0,138,246,0.561,0.556,90,128,0.703,366
Thon Maker,C,20,MIL,74,1238,130,316,0.411,31,104,0.298,99,212,0.467,0.46,65,93,0.699,356
Boban Marjanović,C,29,TOT,39,337,79,148,0.534,0,0,,79,148,0.534,0.534,77,97,0.794,235
Lauri Markkanen,PF,20,CHI,68,2020,374,862,0.434,145,401,0.362,229,461,0.497,0.518,140,166,0.843,1033
Jarell Martin,PF,23,MEM,73,1661,221,496,0.446,34,98,0.347,187,398,0.47,0.48,89,116,0.767,565
Frank Mason III,PG,23,SAC,52,984,144,380,0.379,31,86,0.36,113,294,0.384,0.42,94,115,0.817,413
Mangok Mathiang,C,25,CHO,4,20,4,7,0.571,0,0,,4,7,0.571,0.571,0,1,0.0,8
Wesley Matthews,SF,31,DAL,63,2131,283,697,0.406,153,402,0.381,130,295,0.441,0.516,83,101,0.822,802
Luc Mbah a Moute,PF,31,HOU,61,1564,166,345,0.481,63,173,0.364,103,172,0.599,0.572,65,95,0.684,460
James Michael McAdoo,PF,25,PHI,3,18,2,7,0.286,2,7,0.286,0,0,,0.429,2,2,1.0,8
Patrick McCaw,SG,22,GSW,57,961,92,225,0.409,19,80,0.238,73,145,0.503,0.451,26,34,0.765,229
CJ McCollum,SG,26,POR,81,2923,667,1505,0.443,189,476,0.397,478,1029,0.465,0.506,209,250,0.836,1732
T.J. McConnell,PG,25,PHI,76,1706,210,421,0.499,27,62,0.435,183,359,0.51,0.531,31,39,0.795,478
Erik McCree,SF,24,UTA,4,8,0,2,0.0,0,1,0.0,0,1,0.0,0.0,0,0,,0
Chris McCullough,PF,22,WAS,19,90,18,42,0.429,1,8,0.125,17,34,0.5,0.44,9,14,0.643,46
Doug McDermott,SF,26,TOT,81,1768,237,508,0.467,92,216,0.426,145,292,0.497,0.557,64,81,0.79,630
JaVale McGee,C,30,GSW,65,615,136,219,0.621,0,6,0.0,136,213,0.638,0.621,38,52,0.731,310
Rodney McGruder,SG,26,MIA,18,299,36,73,0.493,15,35,0.429,21,38,0.553,0.596,4,8,0.5,91
Trey McKinney-Jones,SG,27,IND,1,1,0,0,,0,0,,0,0,,,0,0,,0
Alfonzo McKinnie,SF,25,TOR,14,53,8,15,0.533,3,9,0.333,5,6,0.833,0.633,2,3,0.667,21
Ben McLemore,SG,24,MEM,56,1091,157,373,0.421,55,159,0.346,102,214,0.477,0.495,53,64,0.828,422
Josh McRoberts,PF,30,DAL,2,6,0,1,0.0,0,1,0.0,0,0,,0.0,0,0,,0
Jodie Meeks,SG,30,WAS,77,1119,157,393,0.399,72,210,0.343,85,183,0.464,0.491,101,117,0.863,487
Salah Mejri,C,31,DAL,61,729,88,137,0.642,0,3,0.0,88,134,0.657,0.642,38,66,0.576,214
Jordan Mickey,PF,23,MIA,23,284,39,82,0.476,2,16,0.125,37,66,0.561,0.488,13,19,0.684,93
Khris Middleton,SF,26,MIL,82,2982,593,1272,0.466,146,407,0.359,447,865,0.517,0.524,320,362,0.884,1652
C.J. Miles,SF,30,TOR,70,1337,227,599,0.379,164,454,0.361,63,145,0.434,0.516,81,97,0.835,699
Darius Miller,SF,27,NOP,82,1944,216,487,0.444,147,358,0.411,69,129,0.535,0.594,58,67,0.866,637
Malcolm Miller,SF,24,TOR,15,126,13,28,0.464,8,21,0.381,5,7,0.714,0.607,4,4,1.0,38
Patty Mills,PG,29,SAS,82,2107,280,682,0.411,154,414,0.372,126,268,0.47,0.523,105,118,0.89,819
Paul Millsap,PF,32,DEN,38,1143,202,435,0.464,39,113,0.345,163,322,0.506,0.509,112,161,0.696,555
Nikola Mirotić,PF,26,TOT,55,1494,306,684,0.447,135,358,0.377,171,326,0.525,0.546,112,137,0.818,859
Donovan Mitchell,SG,21,UTA,79,2638,595,1362,0.437,187,550,0.34,408,812,0.502,0.506,239,297,0.805,1616
Naz Mitrou-Long,SG,24,UTA,1,1,1,1,1.0,1,1,1.0,0,0,,1.5,0,0,,3
Malik Monk,SG,19,CHO,63,854,153,425,0.36,83,243,0.342,70,182,0.385,0.458,32,38,0.842,421
Greg Monroe,C,27,TOT,51,1040,218,386,0.565,0,0,,218,386,0.565,0.565,88,119,0.739,524
Luis Montero,SG,24,DET,2,8,0,1,0.0,0,0,,0,1,0.0,0.0,0,0,,0
Ben Moore,PF,22,IND,2,9,0,0,,0,0,,0,0,,,0,0,,0
E'Twaun Moore,SG,28,NOP,82,2586,423,832,0.508,128,301,0.425,295,531,0.556,0.585,48,68,0.706,1022
Eric Moreland,PF,26,DET,67,805,66,122,0.541,0,0,,66,122,0.541,0.541,11,29,0.379,143
Jaylen Morris,SG,22,ATL,6,98,13,32,0.406,2,10,0.2,11,22,0.5,0.438,0,0,,28
Marcus Morris,PF,28,BOS,54,1442,262,611,0.429,86,234,0.368,176,377,0.467,0.499,124,154,0.805,734
Markieff Morris,PF,28,WAS,73,1968,330,687,0.48,76,207,0.367,254,480,0.529,0.536,105,128,0.82,841
Monte Morris,PG,22,DEN,3,25,4,6,0.667,0,1,0.0,4,5,0.8,0.667,2,2,1.0,10
Johnathan Motley,PF,22,DAL,11,176,40,75,0.533,1,6,0.167,39,69,0.565,0.54,15,28,0.536,96
Timofey Mozgov,C,31,BRK,31,359,52,93,0.559,4,18,0.222,48,75,0.64,0.581,23,30,0.767,131
Emmanuel Mudiay,PG,21,TOT,64,1245,204,526,0.388,47,148,0.318,157,378,0.415,0.433,98,129,0.76,553
Shabazz Muhammad,SF-SG,25,TOT,43,418,84,188,0.447,7,27,0.259,77,161,0.478,0.465,39,50,0.78,214
Xavier Munford,SG,25,MIL,6,21,1,6,0.167,0,2,0.0,1,4,0.25,0.167,1,2,0.5,3
Dejounte Murray,PG,21,SAS,81,1743,270,609,0.443,9,34,0.265,261,575,0.454,0.451,105,148,0.709,654
Jamal Murray,PG,20,DEN,81,2565,479,1062,0.451,165,436,0.378,314,626,0.502,0.529,229,253,0.905,1352
Mike Muscala,C,26,ATL,53,1060,143,312,0.458,62,167,0.371,81,145,0.559,0.558,57,62,0.919,405
Abdel Nader,SF,24,BOS,48,522,50,149,0.336,23,65,0.354,27,84,0.321,0.413,23,39,0.59,146
Larry Nance Jr.,C,25,TOT,66,1421,240,413,0.581,2,12,0.167,238,401,0.594,0.584,91,137,0.664,573
Shabazz Napier,PG,26,POR,74,1535,223,531,0.42,82,218,0.376,141,313,0.45,0.497,116,138,0.841,644
Jameer Nelson,PG,35,TOT,50,1013,95,244,0.389,41,124,0.331,54,120,0.45,0.473,16,20,0.8,247
Raul Neto,PG,25,UTA,41,498,69,151,0.457,19,47,0.404,50,104,0.481,0.52,26,35,0.743,183
Georges Niang,PF,24,UTA,9,32,4,11,0.364,0,4,0.0,4,7,0.571,0.364,1,2,0.5,9
Joakim Noah,C,32,NYK,7,40,5,10,0.5,0,0,,5,10,0.5,0.5,2,4,0.5,12
Nerlens Noel,C,23,DAL,30,472,55,105,0.524,0,1,0.0,55,104,0.529,0.524,21,28,0.75,131
Lucas Nogueira,C,25,TOR,49,418,49,80,0.613,5,19,0.263,44,61,0.721,0.644,19,28,0.679,122
Dirk Nowitzki,C,39,DAL,77,1900,346,758,0.456,138,337,0.409,208,421,0.494,0.547,97,108,0.898,927
Frank Ntilikina,PG,19,NYK,78,1706,182,500,0.364,50,157,0.318,132,343,0.385,0.414,49,68,0.721,463
Jusuf Nurkić,C,23,POR,79,2088,480,951,0.505,0,7,0.0,480,944,0.508,0.505,172,273,0.63,1132
David Nwaba,SG,25,CHI,70,1646,202,423,0.478,18,52,0.346,184,371,0.496,0.499,133,203,0.655,555
Johnny O'Bryant,PF,24,CHO,36,379,68,171,0.398,14,43,0.326,54,128,0.422,0.439,21,25,0.84,171
Royce O'Neale,SF,24,UTA,69,1150,120,284,0.423,42,118,0.356,78,166,0.47,0.496,61,76,0.803,343
Kyle O'Quinn,C,27,NYK,77,1387,224,384,0.583,4,17,0.235,220,367,0.599,0.589,98,127,0.772,550
Semi Ojeleye,PF,23,BOS,73,1150,65,188,0.346,40,125,0.32,25,63,0.397,0.452,25,41,0.61,195
Emeka Okafor,C,35,NOP,26,353,48,95,0.505,0,0,,48,95,0.505,0.505,18,22,0.818,114
Jahlil Okafor,C,22,TOT,28,353,77,138,0.558,1,4,0.25,76,134,0.567,0.562,21,29,0.724,176
Victor Oladipo,SG,25,IND,75,2552,640,1342,0.477,161,434,0.371,479,908,0.528,0.537,294,368,0.799,1735
Kelly Olynyk,PF,26,MIA,76,1779,316,636,0.497,106,280,0.379,210,356,0.59,0.58,134,174,0.77,872
Chinanu Onuaku,C,21,HOU,1,22,2,5,0.4,0,0,,2,5,0.4,0.4,0,0,,4
Cedi Osman,SF,22,CLE,61,672,90,186,0.484,32,87,0.368,58,99,0.586,0.57,26,46,0.565,238
Kelly Oubre Jr.,SF,22,WAS,81,2231,318,790,0.403,126,369,0.341,192,421,0.456,0.482,191,233,0.82,953
Zaza Pachulia,C,33,GSW,69,972,149,264,0.564,0,1,0.0,149,263,0.567,0.564,75,93,0.806,373
Marcus Paige,PG,24,CHO,5,28,4,14,0.286,2,8,0.25,2,6,0.333,0.357,2,2,1.0,12
Georgios Papagiannis,C,20,TOT,17,122,18,42,0.429,0,0,,18,42,0.429,0.429,0,0,,36
Jabari Parker,PF,22,MIL,31,743,160,332,0.482,31,81,0.383,129,251,0.514,0.529,40,54,0.741,391
Tony Parker,PG,35,SAS,55,1071,178,388,0.459,10,37,0.27,168,351,0.479,0.472,55,78,0.705,421
Chandler Parsons,SF,29,MEM,36,691,108,234,0.462,51,121,0.421,57,113,0.504,0.571,17,27,0.63,284
Patrick Patterson,PF,28,OKC,82,1270,106,266,0.398,66,171,0.386,40,95,0.421,0.523,40,46,0.87,318
Justin Patton,C,20,MIN,1,4,1,2,0.5,0,0,,1,2,0.5,0.5,0,0,,2
Brandon Paul,SG,26,SAS,64,576,55,127,0.433,15,54,0.278,40,73,0.548,0.492,22,43,0.512,147
Chris Paul,PG,32,HOU,58,1847,367,798,0.46,144,379,0.38,223,419,0.532,0.55,203,221,0.919,1081
Adreian Payne,PF,26,ORL,5,43,7,10,0.7,2,3,0.667,5,7,0.714,0.8,5,6,0.833,21
Cameron Payne,PG,23,CHI,25,582,87,215,0.405,35,91,0.385,52,124,0.419,0.486,12,16,0.75,221
Elfrid Payton,PG,23,TOT,63,1808,329,667,0.493,30,92,0.326,299,575,0.52,0.516,109,168,0.649,797
Gary Payton II,PG,25,TOT,23,221,30,74,0.405,6,25,0.24,24,49,0.49,0.446,3,9,0.333,69
Kendrick Perkins,C,33,CLE,1,15,1,2,0.5,0,0,,1,2,0.5,0.5,1,2,0.5,3
London Perrantes,PG,23,CLE,14,66,2,13,0.154,0,3,0.0,2,10,0.2,0.154,3,5,0.6,7
Alec Peters,PF,22,PHO,20,225,28,74,0.378,18,58,0.31,10,16,0.625,0.5,8,10,0.8,82
Marshall Plumlee,C,25,MIL,8,52,1,3,0.333,0,0,,1,3,0.333,0.333,12,16,0.75,14
Mason Plumlee,C,27,DEN,74,1439,221,368,0.601,0,1,0.0,221,367,0.602,0.601,82,179,0.458,524
Miles Plumlee,C,29,ATL,55,918,105,180,0.583,0,0,,105,180,0.583,0.583,27,60,0.45,237
Jakob Poeltl,C,22,TOR,82,1524,253,384,0.659,1,2,0.5,252,382,0.66,0.66,60,101,0.594,567
Quincy Pondexter,SF,29,CHI,23,196,14,49,0.286,3,22,0.136,11,27,0.407,0.316,14,17,0.824,45
Otto Porter Jr.,SF,24,WAS,77,2432,445,885,0.503,138,313,0.441,307,572,0.537,0.581,106,128,0.828,1134
Bobby Portis,PF,22,CHI,73,1643,382,811,0.471,80,223,0.359,302,588,0.514,0.52,120,156,0.769,964
Kristaps Porziņģis,PF,22,NYK,48,1553,390,889,0.439,90,228,0.395,300,661,0.454,0.489,218,275,0.793,1088
Dwight Powell,C,26,DAL,79,1672,255,430,0.593,28,84,0.333,227,346,0.656,0.626,133,185,0.719,671
Norman Powell,SG,24,TOR,70,1062,150,374,0.401,53,186,0.285,97,188,0.516,0.472,32,39,0.821,385
Alex Poythress,PF,24,IND,25,104,11,26,0.423,4,11,0.364,7,15,0.467,0.5,0,0,,26
Taurean Prince,SF,23,ATL,82,2464,415,975,0.426,176,457,0.385,239,518,0.461,0.516,152,180,0.844,1158
Jacob Pullen,PG,28,PHI,3,6,1,2,0.5,0,1,0.0,1,1,1.0,0.5,0,0,,2
Rodney Purvis,SG,23,ORL,16,290,35,107,0.327,13,52,0.25,22,55,0.4,0.388,13,15,0.867,96
Zhou Qi,C,22,HOU,18,124,6,32,0.188,2,19,0.105,4,13,0.308,0.219,8,12,0.667,22
Tim Quarterman,SG,23,HOU,3,13,1,3,0.333,0,2,0.0,1,1,1.0,0.333,2,2,1.0,4
Ivan Rabb,PF,20,MEM,36,516,86,152,0.566,0,0,,86,152,0.566,0.566,29,36,0.806,201
Julius Randle,C,23,LAL,82,2190,504,904,0.558,10,45,0.222,494,859,0.575,0.563,305,425,0.718,1323
Zach Randolph,PF,36,SAC,59,1508,361,763,0.473,51,147,0.347,310,616,0.503,0.507,84,107,0.785,857
Xavier Rathan-Mayes,SG,23,MEM,5,118,12,42,0.286,1,14,0.071,11,28,0.393,0.298,4,9,0.444,29
J.J. Redick,SG,33,PHI,70,2116,404,879,0.46,193,460,0.42,211,419,0.504,0.569,197,218,0.904,1198
Davon Reed,SG,22,PHO,21,242,22,76,0.289,11,38,0.289,11,38,0.289,0.362,8,12,0.667,63
Willie Reed,C,27,TOT,42,428,81,121,0.669,1,2,0.5,80,119,0.672,0.674,32,55,0.582,195
Josh Richardson,SF,24,MIA,81,2689,399,885,0.451,127,336,0.378,272,549,0.495,0.523,120,142,0.845,1045
Malachi Richardson,SG,22,TOT,26,324,30,90,0.333,12,40,0.3,18,50,0.36,0.4,17,22,0.773,89
Austin Rivers,SG,25,LAC,61,2057,341,805,0.424,136,360,0.378,205,445,0.461,0.508,102,159,0.642,920
Andre Roberson,SG,26,OKC,39,1037,87,162,0.537,8,36,0.222,79,126,0.627,0.562,12,38,0.316,194
Devin Robinson,SF,22,WAS,1,13,1,3,0.333,0,0,,1,3,0.333,0.333,0,0,,2
Glenn Robinson III,SF,24,IND,23,338,36,85,0.424,14,34,0.412,22,51,0.431,0.506,9,11,0.818,95
Rajon Rondo,PG,31,NOP,65,1705,231,494,0.468,50,150,0.333,181,344,0.526,0.518,25,46,0.543,537
Derrick Rose,PG,29,TOT,25,420,81,186,0.435,7,30,0.233,74,156,0.474,0.454,40,46,0.87,209
Terrence Ross,SG,26,ORL,24,600,76,191,0.398,30,93,0.323,46,98,0.469,0.476,27,36,0.75,209
Terry Rozier,PG,23,BOS,80,2068,316,800,0.395,153,402,0.381,163,398,0.41,0.491,115,149,0.772,900
Ricky Rubio,PG,27,UTA,77,2254,346,827,0.418,96,273,0.352,250,554,0.451,0.476,220,254,0.866,1008
D'Angelo Russell,PG,21,BRK,48,1234,278,672,0.414,90,278,0.324,188,394,0.477,0.481,97,131,0.74,743
Domantas Sabonis,C,21,IND,74,1810,340,661,0.514,13,37,0.351,327,624,0.524,0.524,168,224,0.75,861
JaKarr Sampson,SF,24,SAC,22,344,44,81,0.543,5,10,0.5,39,71,0.549,0.574,10,16,0.625,103
Dario Šarić,PF,23,PHI,78,2310,403,890,0.453,157,399,0.393,246,491,0.501,0.541,178,207,0.86,1141
Tomáš Satoranský,SG,26,WAS,73,1643,201,384,0.523,47,101,0.465,154,283,0.544,0.585,75,96,0.781,524
Dennis Schröder,PG,24,ATL,67,2078,500,1146,0.436,76,262,0.29,424,884,0.48,0.469,225,265,0.849,1301
Mike Scott,PF,29,WAS,76,1406,276,524,0.527,66,163,0.405,210,361,0.582,0.59,50,76,0.658,668
Thabo Sefolosha,SF,33,UTA,38,806,118,240,0.492,32,84,0.381,86,156,0.551,0.558,44,54,0.815,312
Wayne Selden,SG,23,MEM,35,692,116,269,0.431,49,122,0.402,67,147,0.456,0.522,44,59,0.746,325
Ramon Sessions,PG,31,TOT,28,392,42,117,0.359,8,26,0.308,34,91,0.374,0.393,44,57,0.772,136
Iman Shumpert,SG,27,CLE,14,276,22,58,0.379,7,26,0.269,15,32,0.469,0.44,11,15,0.733,62
Pascal Siakam,PF,23,TOR,81,1679,253,498,0.508,29,132,0.22,224,366,0.612,0.537,54,87,0.621,589
Xavier Silas,SG,30,BOS,2,7,0,3,0.0,0,2,0.0,0,1,0.0,0.0,0,0,,0
Ben Simmons,PG,21,PHI,81,2732,544,998,0.545,0,11,0.0,544,987,0.551,0.545,191,341,0.56,1279
Jonathon Simmons,SG,28,ORL,69,2029,354,761,0.465,69,204,0.338,285,557,0.512,0.511,185,241,0.768,962
Kobi Simmons,PG,20,MEM,32,643,80,189,0.423,11,39,0.282,69,150,0.46,0.452,25,25,1.0,196
Kyle Singler,SF,29,OKC,12,59,7,21,0.333,2,5,0.4,5,16,0.313,0.381,7,13,0.538,23
Marcus Smart,SG,23,BOS,54,1614,189,515,0.367,75,249,0.301,114,266,0.429,0.44,97,133,0.729,550
Dennis Smith Jr.,PG,20,DAL,69,2049,404,1024,0.395,106,339,0.313,298,685,0.435,0.446,134,193,0.694,1048
Ish Smith,PG,29,DET,82,2043,389,801,0.486,35,101,0.347,354,700,0.506,0.507,81,116,0.698,894
J.R. Smith,SG,32,CLE,80,2244,240,595,0.403,143,381,0.375,97,214,0.453,0.524,39,56,0.696,662
Jason Smith,C,31,WAS,33,285,45,115,0.391,4,32,0.125,41,83,0.494,0.409,19,21,0.905,113
Josh Smith,PF,32,NOP,3,12,1,4,0.25,0,0,,1,4,0.25,0.25,0,0,,2
Tony Snell,SG,26,MIL,75,2053,185,425,0.435,108,268,0.403,77,157,0.49,0.562,38,48,0.792,516
Marreese Speights,C,30,ORL,52,675,138,349,0.395,86,233,0.369,52,116,0.448,0.519,40,55,0.727,402
Nik Stauskas,SG,24,TOT,41,523,60,154,0.39,40,100,0.4,20,54,0.37,0.519,21,29,0.724,181
Lance Stephenson,SG,27,IND,82,1850,303,709,0.427,67,232,0.289,236,477,0.495,0.475,84,127,0.661,757
David Stockton,PG,26,UTA,3,9,2,3,0.667,2,3,0.667,0,0,,1.0,4,4,1.0,10
Julyan Stone,SG,29,CHO,23,175,6,13,0.462,6,13,0.462,0,0,,0.692,1,2,0.5,19
Edmond Sumner,PG,22,IND,1,2,1,1,1.0,0,0,,1,1,1.0,1.0,0,0,,2
Caleb Swanigan,PF,20,POR,27,189,24,60,0.4,1,8,0.125,23,52,0.442,0.408,12,18,0.667,61
Jayson Tatum,SF,19,BOS,80,2443,397,835,0.475,105,242,0.434,292,593,0.492,0.538,213,258,0.826,1112
Isaiah Taylor,PG,23,ATL,67,1167,163,390,0.418,20,80,0.25,143,310,0.461,0.444,99,141,0.702,445
Jeff Teague,PG,29,MIN,70,2311,354,794,0.446,84,228,0.368,270,566,0.477,0.499,202,239,0.845,994
Marquis Teague,PG,24,MEM,3,74,4,16,0.25,1,4,0.25,3,12,0.25,0.281,2,5,0.4,11
Mirza Teletović,PF,32,MIL,10,159,25,57,0.439,21,45,0.467,4,12,0.333,0.623,0,0,,71
Garrett Temple,SG,31,SAC,65,1615,199,476,0.418,89,227,0.392,110,249,0.442,0.512,60,78,0.769,547
Miloš Teodosić,PG,30,LAC,45,1134,151,360,0.419,88,232,0.379,63,128,0.492,0.542,39,46,0.848,429
Jason Terry,SG,40,MIL,51,814,59,154,0.383,40,115,0.348,19,39,0.487,0.513,8,9,0.889,166
Daniel Theis,C,25,BOS,63,936,126,233,0.541,18,58,0.31,108,175,0.617,0.579,61,81,0.753,331
Isaiah Thomas,PG,28,TOT,32,862,157,421,0.373,55,188,0.293,102,233,0.438,0.438,117,131,0.893,486
Lance Thomas,PF,29,NYK,73,1353,102,267,0.382,50,124,0.403,52,143,0.364,0.476,44,53,0.83,298
Klay Thompson,SG,27,GSW,73,2506,575,1179,0.488,229,521,0.44,346,658,0.526,0.585,82,98,0.837,1461
Tristan Thompson,C,26,CLE,53,1072,132,235,0.562,0,0,,132,235,0.562,0.562,43,79,0.544,307
Sindarius Thornwell,SG,23,LAC,73,1156,100,233,0.429,23,61,0.377,77,172,0.448,0.479,59,88,0.67,282
Anthony Tolliver,PF,32,DET,79,1757,219,472,0.464,159,365,0.436,60,107,0.561,0.632,106,133,0.797,703
Karl-Anthony Towns,C,22,MIN,82,2918,639,1172,0.545,120,285,0.421,519,887,0.585,0.596,345,402,0.858,1743
P.J. Tucker,PF,32,HOU,82,2281,172,441,0.39,115,310,0.371,57,131,0.435,0.52,43,60,0.717,502
Evan Turner,SF,29,POR,79,2034,258,577,0.447,42,132,0.318,216,445,0.485,0.484,91,107,0.85,649
Myles Turner,C,21,IND,65,1836,306,639,0.479,56,157,0.357,250,482,0.519,0.523,160,206,0.777,828
Ekpe Udoh,C,30,UTA,63,810,60,120,0.5,0,1,0.0,60,119,0.504,0.5,42,56,0.75,162
Tyler Ulis,PG,22,PHO,71,1658,214,551,0.388,42,146,0.288,172,405,0.425,0.426,84,101,0.832,554
Jonas Valančiūnas,C,25,TOR,77,1727,390,687,0.568,30,74,0.405,360,613,0.587,0.59,170,211,0.806,980
Denzel Valentine,SG,24,CHI,77,2095,301,721,0.417,143,370,0.386,158,351,0.45,0.517,38,51,0.745,783
Fred VanVleet,PG,23,TOR,76,1520,232,545,0.426,108,261,0.414,124,284,0.437,0.525,84,101,0.832,656
Rashad Vaughn,SG,21,TOT,28,212,23,56,0.411,14,37,0.378,9,19,0.474,0.536,4,6,0.667,64
Noah Vonleh,PF,22,TOT,54,875,104,234,0.444,20,66,0.303,84,168,0.5,0.487,36,58,0.621,264
Nikola Vučević,C,27,ORL,57,1683,399,840,0.475,64,204,0.314,335,636,0.527,0.513,77,94,0.819,939
Dwyane Wade,SG,36,TOT,67,1536,299,682,0.438,32,111,0.288,267,571,0.468,0.462,135,189,0.714,765
Dion Waiters,SG,26,MIA,30,918,163,410,0.398,52,170,0.306,111,240,0.463,0.461,51,69,0.739,429
Kemba Walker,PG,27,CHO,80,2736,588,1363,0.431,231,601,0.384,357,762,0.469,0.516,363,420,0.864,1770
John Wall,PG,27,WAS,41,1410,280,667,0.42,62,167,0.371,218,500,0.436,0.466,175,241,0.726,797
Tyrone Wallace,PG,23,LAC,30,851,110,247,0.445,10,40,0.25,100,207,0.483,0.466,61,78,0.782,291
Derrick Walton,PG,22,MIA,16,147,8,25,0.32,7,17,0.412,1,8,0.125,0.46,6,6,1.0,29
Jameel Warney,PF,24,DAL,3,27,7,12,0.583,0,0,,7,12,0.583,0.583,3,5,0.6,17
T.J. Warren,SF,24,PHO,65,2142,529,1063,0.498,20,90,0.222,509,973,0.523,0.507,193,255,0.757,1271
Travis Wear,SF,27,LAL,17,228,25,72,0.347,17,47,0.362,8,25,0.32,0.465,8,8,1.0,75
James Webb III,SF,24,BRK,10,120,6,24,0.25,4,19,0.211,2,5,0.4,0.333,0,0,,16
Briante Weber,PG,25,TOT,18,237,19,43,0.442,4,11,0.364,15,32,0.469,0.488,8,10,0.8,50
David West,C,37,GSW,73,999,216,378,0.571,3,8,0.375,213,370,0.576,0.575,60,79,0.759,495
Russell Westbrook,PG,29,OKC,80,2914,757,1687,0.449,97,326,0.298,660,1361,0.485,0.477,417,566,0.737,2028
Andrew White,SF,24,ATL,15,209,25,73,0.342,18,49,0.367,7,24,0.292,0.466,1,4,0.25,69
Derrick White,PG,23,SAS,17,139,16,33,0.485,8,13,0.615,8,20,0.4,0.606,14,20,0.7,54
Okaro White,PF,25,MIA,6,80,7,16,0.438,4,11,0.364,3,5,0.6,0.563,2,3,0.667,20
Isaiah Whitehead,PG,22,BRK,16,180,40,86,0.465,7,18,0.389,33,68,0.485,0.506,13,19,0.684,100
Hassan Whiteside,C,28,MIA,54,1364,312,578,0.54,2,2,1.0,310,576,0.538,0.542,128,182,0.703,754
Andrew Wiggins,SF,22,MIN,82,2979,569,1300,0.438,112,338,0.331,457,962,0.475,0.481,202,314,0.643,1452
Jacob Wiley,PF,23,BRK,5,33,1,4,0.25,1,2,0.5,0,2,0.0,0.375,1,2,0.5,4
Damien Wilkins,SF,38,IND,19,152,13,39,0.333,4,18,0.222,9,21,0.429,0.385,3,4,0.75,33
Alan Williams,PF,25,PHO,5,70,7,18,0.389,0,0,,7,18,0.389,0.389,6,9,0.667,20
C.J. Williams,SG,27,LAC,38,707,87,197,0.442,22,78,0.282,65,119,0.546,0.497,13,16,0.813,209
Derrick Williams,PF,26,LAL,2,9,1,4,0.25,0,2,0.0,1,2,0.5,0.25,0,0,,2
Lou Williams,SG,31,LAC,79,2589,582,1337,0.435,186,518,0.359,396,819,0.484,0.505,432,491,0.88,1782
Marvin Williams,PF,31,CHO,78,2006,258,563,0.458,126,305,0.413,132,258,0.512,0.57,102,123,0.829,744
Matt Williams,SG,24,MIA,3,11,2,6,0.333,1,5,0.2,1,1,1.0,0.417,0,0,,5
Troy Williams,SF,23,TOT,21,307,51,109,0.468,11,38,0.289,40,71,0.563,0.518,20,30,0.667,133
D.J. Wilson,PF,21,MIL,22,71,9,16,0.563,2,5,0.4,7,11,0.636,0.625,1,2,0.5,21
Jamil Wilson,SF,27,LAC,15,274,38,81,0.469,27,63,0.429,11,18,0.611,0.636,2,4,0.5,105
Justise Winslow,PF,21,MIA,68,1680,207,488,0.424,49,129,0.38,158,359,0.44,0.474,66,104,0.635,529
Jeff Withey,C,27,DAL,9,39,6,16,0.375,2,10,0.2,4,6,0.667,0.438,1,2,0.5,15
Nate Wolters,PG,26,UTA,5,19,1,6,0.167,0,0,,1,6,0.167,0.167,0,0,,2
Brandan Wright,PF,30,TOT,28,381,59,102,0.578,0,0,,59,102,0.578,0.578,21,33,0.636,139
Delon Wright,PG,25,TOR,69,1433,201,432,0.465,56,153,0.366,145,279,0.52,0.53,97,117,0.829,555
Guerschon Yabusele,PF,22,BOS,33,235,26,61,0.426,12,37,0.324,14,24,0.583,0.525,15,22,0.682,79
James Young,SG,22,PHI,6,61,5,14,0.357,3,10,0.3,2,4,0.5,0.464,4,6,0.667,17
Joe Young,PG,25,IND,53,558,80,186,0.43,25,66,0.379,55,120,0.458,0.497,22,29,0.759,207
Nick Young,SG,32,GSW,80,1393,201,488,0.412,123,326,0.377,78,162,0.481,0.538,56,65,0.862,581
Thaddeus Young,PF,29,IND,81,2607,421,864,0.487,58,181,0.32,363,683,0.531,0.521,55,92,0.598,955
Cody Zeller,C,25,CHO,33,627,85,156,0.545,2,3,0.667,83,153,0.542,0.551,61,85,0.718,233
Tyler Zeller,C,28,TOT,66,1109,187,334,0.56,10,28,0.357,177,306,0.578,0.575,57,79,0.722,441
Paul Zipser,SF,23,CHI,54,824,81,234,0.346,37,110,0.336,44,124,0.355,0.425,19,25,0.76,218
Ante Žižić,C,21,CLE,32,214,49,67,0.731,0,0,,49,67,0.731,0.731,21,29,0.724,119
Ivica Zubac,C,20,LAL,43,410,61,122,0.5,0,1,0.0,61,121,0.504,0.5,39,51,0.765,161
